******************************
*___*P_______*____________*__*
*D*_*__****__*_*****_*_*****_*
*_*_****_____*_*___*_*_____*_*
*_*______*___*_*_*_*_*_***_*_*
*_**_P_*_*****_*_***_*_*P__*_*
*_P*___*_______*___P_*_*****_*
*__*****_*******_____*_______*
*______*_______P_***********_*
*P_***_*P__________________*_*
*__*_*____***********_*_**_*_*
*__*_***__*_____*_____*_*P_*_*
*P_*______*_____*****_*_****_*
*__******_*****_____*_*______*
*_____________*_____*_******_*
*_**********__*__****______*_*
*__*_______****__*____****_*_*
*P_*P_***________******P_*_*_*
*__****___******_________*_*_*
*_______P_*____***********_*_*
********__**_______________*_*
*__________*****************_*
*_********________*__P_______*
*_*______*_********__________*
*_*_****_*__________**********
*_*_****_*_*****___**________*
*_*_****_*_*___*_______*******
*_*_****_*_***_********__P__A*
*____________________________*
******************************
