******************************
*********D  * ****************
********* *** ****************
********* *     *   **********
********* * *** *** **********
*             * ***     ******
******* ******* ***** * ******
* *     ***     ***   * ******
* ***** *********** * ********
*   *         ***   * ********
*** * *** *** *** ************
*   * *** *         **********
*** * ***** *** *** **********
***   *****   *   * **********
*********** * *** ************
*********** *   *         ****
***************** ***** * ****
*************     ***   * ****
*************** ********* ****
*****   * ***** ***** ***   **
***** *** *********** ***** **
***** *   ***********     *  *
***** *** ************* *** **
***** *   ************* *    *
***** * *************** * ****
*****A  *     *   *     * ****
******* * *** * ******* * ****
*     *   * *           * ****
* * * * *** ********* *** ****
******************************
